|-------------------|
|   |               |
|   |   --------    |
|       |           |
|   |---    --------|
|   |       |       M
|   |   |---|   ----|
| * |               |
|-------------------|